m:
1 0   4   0   1
3 204 3   0   3
1 2   1   2   1
3 204 3   0   3
1 2   1   2   1
3 0   3   204 3
1 2   1   2   1
3 204 3   0   3
1 0   1   0   1

e:
h 4 4