m:
1 0   4   0   1
3 205 3   207 3
1 2   1   2   1
3 207 3   207 3
1 2   1   2   1
3 207 3   205 3
1 2   1   2   1
3 207 3   207 3
1 0   1   0   1

e:
h 4 4