param:
hero 7 0

m:
0 0 0 0 0
0 0 0 9 0
0 0 0 6 0
0 0 0 6 0
8 7 7 8 0
6 0 0 0 0
6 0 0 0 0
8 0 0 0 0

d:
200 3 2
200 6 2